##################
#                #
#  ##            #
# #  #           #
# #  #           #
#  ##     ##     #
#        #  #    #
#       .$ $ #   #
#      #     $.  #
#      ########  #
#      #      #  #
#      #$. $# .  #
#      # #  .$#  #
#      # $    #  #
#     $.$ .. $.  #
#@   $ . $..  #  #
##################