        #######
       ##  @  ##
     ###   $   ###
     #           #
   ###           ###
   #  ###     ###  #
  ##    ##   ##    ##
 ##    # .$  # #    ##
 #     #$#  $.$.     #
 #     .$.$  # #     #
 # ### # #   . . ### #
 ### ## #     # ## ###
 # ### #       # ### #
 ##    ###.###.#    ##
  ## $ . . # #$#   ##
   #   # # # # #   #
   ## $###.###.# ###
     #    $  $   #
     ###    $  ###
       ##     ##
        #######