
 ##
#  #
#  #
 ##      ##
        #  #
	   #    #
	  #      #
	  ########
	  #      #
	  # .  # .
	  # #  . #
	  #      #
	  .  ..  .
@	  .  ..  #
###############