        #######
       #       #
     ##         ##
     #      $    #
   ##       #$    ##
   #  ###     ###  #
  #     ##   ##     #
 #     # #   # #     #
 #     # #   # #     #
 #     # #   # #  $  #
 #     # #   # #     #
 #  $   .  @  .      #
 #                   #
 #     #########     #
  #    # # # # #    #
   #   # # # # #   #
   ##  #########  ##
     #           #
     ##         ##
       #       #
        #######